Arizona-Cardinals	#cardinals #arizonacardinals #azcardinals #gocards #gocardsgo #letsgocards #gocardinals #gocardinalsgo #letsgocardinals #cardinalnation #cardinalsnation
Atlanta-Falcons	#falcons #atlantafalcons #gofalcons #letsgofalcons #gofalconsgo #dirtybird #dirtybirds #falconnation #falconsnation
Baltimore-Ravens	#ravens #baltimoreravens #teamravens #letsgoravens #goravens #goravensgo #ravennation #ravensnation
Buffalo-Bills	#bills #buffalobills #billsmafia #gobills #gobillsgo #letsgobills #billnation #billsnation
Carolina-Panthers	#panthers #carolinapanthers #gopanthers #gopanthersgo #letsgopanthers #panthernation #panthersnation
Chicago-Bears	#bears #chicagobears #dabears #gobears #gobearsgo #letsgobears #bearsnation #bearnation #beardown #bearsfam
Cincinnati-Bengals	#bengals #cincinnatibengals #gobengals #gobengalsgo #letsgobengals #bengalnation #bengalsnation #whodey #whodeynation
Cleveland-Browns	#browns #clevelandbrowns #gobrowns #gobrownsgo #letsgobrowns #brownnation #brownsnation
Dallas-Cowboys	#cowboys #dallascowboys #gocowboys #gocowboysgo #letsgocowboys #cowboynation #cowboysnation #americasteam
Denver-Broncos	#broncos #denverbroncos #gobroncos #gobroncosgo #letsgobroncos #broncosnation #bronconation
Detroit-Lions	#lions #detroitlions #golions #golionsgo #letsgolions #lionnation #lionsnation #lionup
Green-Bay-Packers	#packers #greenbaypackers #gbpackers #gopackers #gopackersgo #letsgopackers #gopack #gopackgo #packernation #packersnation
Houston-Texans	#texans #houstontexans #gotexans #gotexansgo #letsgotexans #texannation #texansnation
Indianapolis-Colts	#colts #indianapoliscolts #gocolts #gocoltsgo #letsgocolts #coltnation #coltsnation #coltstrong
Jacksonville-Jaguars	#jaguars #jacksonvillejaguars #jags #jacksonvillejags #gojaguars #gojaguarsgo #letsgojaguars #gojags #gojagsgo #letsgojags #jaguarnation #jaguarsnation #jagnation #jagsnation
Kansas-City-Chiefs	#chiefs #kansascitychiefs #kcchiefs #gochiefs #gochiefsgo #letsgochiefs #arrowheadnation #chiefnation #chiefsnation
Miami-Dolphins	#dolphins #miamidolphins #phins #godolphins #godolphinsgo #letsgodolphins #gophins #gophinsgo #letsgophins #phinnation #phinsnation #dolphinnation #dolphinsnation
Minnesota-Vikings	#vikings #minnesotavikings #govikings #govikingsgo #letsgovikings #vikingnation #vikingsnation
New-England-Patriots	#patriots #newenglandpatriots #pats #nepats #nepatriots #gopats #letsgopats #gopatsgo #gopatriots #letsgopatriots #gopatriotsgo #patriotnation #patriotsnation #patsnation
New-Orleans-Saints	#saints #neworleanssaints #nosaints #gosaints #gosaintsgo #letsgosaints #saintnation #saintsnation
New-York-Giants	#giants #newyorkgiants #newyorkfootballgiants #nygiants #nyg #nygmen #gmen #gogiants #gonygiants #gogiantsgo #letsgogiants #giantsnation #giantnation
New-York-Jets	#jets #newyorkjets #jetlife #nyjets #jetsjetsjets #gojets #gojetsgo #letsgojets #jetnation #jetsnation
Las-Vegas-Raiders	#raiders #oaklandraiders #silverandblack #goraiders #goraidersgo #letsgoraiders #raidernation #raidersnation
Philadelphia-Eagles	#eagles #philadelphiaeagles #flyeaglesfly #iggles #goeagles #goeaglesgo #letsgoeagles #eaglenation #eaglesnation
Pittsburgh-Steelers	#steelers #pittsburghsteelers #stillers #gosteelers #gosteelersgo #letsgosteelers #gostillers #gostillersgo #letsgostillers #stillernation #stillersnation #steelernation #steelersnation
Los-Angeles-Chargers	#chargers #losangeleschargers #lachargers #gochargers #letsgochargers #gochargersgo #chargernation #chargersnation
Seattle-Seahawks	#seahawks #seattleseahawks #goseahawks #letsgoseahawks #goseahawksgo #seahawknation #seahawksnation
San-Francisco-49ers	#49ers #sanfrancisco49ers #sf49ers #niners #sfniners #goniners #goninersgo #letsgoniners #go49ers #go49ersgo #letsgo49ers #49ernation #49ersnation #ninernation #ninersnation
Los-Angeles-Rams	#rams #losangelesrams #larams #gorams #goramsgo #letsgorams #ramsnation #ramnation
Tampa-Bay-Buccaneers	#buccaneers #tampabaybuccaneers #bucs #tampabaybucs #tbbuccaneers #tbbucs #gobucsgo #gobucs #letsgobucs #gobuccaneers #letsgobuccaneers #bucnation #bucsnation
Tennessee-Titans	#titans #tennesseetitans #gotitans #letsgotitans #gotitansgo #titansnation #titannation
Washington-Football-Team	#redskins #washingtonredskins #redskinsdisciples #redskindisciples #goredskins #goredskinsgo #letsgoredskins #goskins #goskinsgo #letsgoskins #redskinsnation #redskinnation
